40
40
1 1 7 1 1 2 2 1 1 1 1 1 1 1 1 1 1 1 1 1 7 1 7 1 1 2 2 1 1 1 1 1 1 1 1 1 1 1 1 1
1 1 1 1 1 1 2 2 1 1 1 1 1 1 1 6 1 1 1 1 7 1 1 1 1 1 2 2 1 1 1 1 1 1 1 6 1 1 1 1
1 1 1 1 1 1 1 1 1 1 1 1 1 1 1 6 1 7 1 1 7 1 1 1 1 1 1 1 1 1 1 1 1 1 1 6 1 7 1 1
1 1 1 7 1 1 1 1 1 1 1 1 1 1 1 6 1 7 1 1 7 1 1 7 1 1 1 1 1 1 1 1 1 1 1 6 1 7 1 1
1 1 1 1 1 1 1 7 1 1 1 1 1 1 1 6 1 7 1 1 7 1 1 1 1 1 1 7 1 1 1 1 1 1 1 6 1 7 1 1
1 7 1 1 1 1 1 7 1 1 3 1 1 1 1 6 1 7 1 1 7 7 1 1 1 1 1 7 1 1 3 1 1 1 1 6 1 7 1 1
1 1 1 1 1 1 1 7 1 1 3 1 1 1 1 6 1 1 1 1 7 1 1 1 1 1 1 7 1 1 3 1 1 1 1 6 1 1 1 1
1 1 1 1 1 7 1 7 1 1 3 4 1 1 1 6 1 1 6 1 7 1 1 1 1 7 1 7 1 1 3 4 1 1 1 6 1 1 6 1
1 1 1 1 1 1 1 7 1 1 3 4 1 1 1 1 1 1 6 1 1 1 1 1 1 1 1 7 1 1 3 4 1 1 1 1 1 1 6 1
1 1 1 1 1 1 1 7 1 1 3 4 1 1 1 1 1 1 7 1 7 1 1 1 1 1 1 7 1 1 3 4 1 1 1 1 1 1 7 1
1 1 1 1 1 1 1 1 1 1 3 4 4 4 4 4 1 1 7 1 7 1 1 1 1 1 1 1 1 1 3 4 4 4 4 4 1 1 7 1
1 1 1 1 1 1 1 7 1 1 1 1 1 1 1 4 1 1 7 1 7 1 1 1 1 1 1 7 1 1 1 1 1 1 1 4 1 1 7 1
1 1 1 1 1 1 1 1 1 1 1 1 1 1 1 4 1 1 7 1 7 1 1 1 1 1 1 1 1 1 1 1 1 1 1 4 1 1 7 1
1 7 1 1 1 1 1 1 1 1 5 1 1 1 1 1 1 1 7 1 7 7 1 1 1 1 1 1 1 1 5 1 1 1 1 1 1 1 7 1
1 7 1 1 7 1 1 1 1 1 5 1 1 1 1 1 1 1 7 1 7 7 1 1 7 1 1 1 1 1 5 1 1 1 1 1 1 1 7 1
1 1 7 1 7 1 1 7 1 1 5 1 1 1 1 1 1 1 7 1 7 1 7 1 7 1 1 7 1 1 5 1 1 1 1 1 1 1 7 1
1 1 1 1 7 1 1 7 1 1 5 1 1 1 1 1 1 1 7 1 7 1 1 1 7 1 1 7 1 1 5 1 1 1 1 1 1 1 7 1
1 7 7 7 7 1 7 7 1 1 5 5 5 5 5 1 1 1 1 1 7 7 7 7 7 1 7 7 1 1 5 5 5 5 5 1 1 1 1 1
1 1 1 1 1 1 1 1 1 1 1 1 1 1 1 1 1 1 1 1 7 1 1 1 1 1 1 1 1 1 1 1 1 1 1 1 1 1 1 1
7 7 7 7 7 7 7 7 1 1 1 7 7 7 7 7 7 7 7 7 7 7 7 7 7 7 7 7 1 1 1 7 7 7 7 7 7 7 7 7
1 1 7 1 1 2 2 1 1 1 1 1 1 1 1 1 1 1 1 1 7 1 7 1 1 2 2 1 1 1 1 1 1 1 1 1 1 1 1 1
1 1 1 1 1 1 2 2 1 1 1 1 1 1 1 6 1 1 1 1 7 1 1 1 1 1 2 2 1 1 1 1 1 1 1 6 1 1 1 1
1 1 1 1 1 1 1 1 1 1 1 1 1 1 1 6 1 7 1 1 7 1 1 1 1 1 1 1 1 1 1 1 1 1 1 6 1 7 1 1
1 1 1 7 1 1 1 1 1 1 1 1 1 1 1 6 1 7 1 1 7 1 1 7 1 1 1 1 1 1 1 1 1 1 1 6 1 7 1 1
1 1 1 1 1 1 1 7 1 1 1 1 1 1 1 6 1 7 1 1 7 1 1 1 1 1 1 7 1 1 1 1 1 1 1 6 1 7 1 1
1 7 1 1 1 1 1 7 1 1 3 1 1 1 1 6 1 7 1 1 7 7 1 1 1 1 1 7 1 1 3 1 1 1 1 6 1 7 1 1
1 1 1 1 1 1 1 7 1 1 3 1 1 1 1 6 1 1 1 1 7 1 1 1 1 1 1 7 1 1 3 1 1 1 1 6 1 1 1 1
1 1 1 1 1 7 1 7 1 1 3 4 1 1 1 6 1 1 6 1 7 1 1 1 1 7 1 7 1 1 3 4 1 1 1 6 1 1 6 1
1 1 1 1 1 1 1 7 1 1 3 4 1 1 1 1 1 1 6 1 7 1 1 1 1 1 1 7 1 1 3 4 1 1 1 1 1 1 6 1
1 1 1 1 1 1 1 7 1 1 3 4 1 1 1 1 1 1 7 1 7 1 1 1 1 1 1 7 1 1 3 4 1 1 1 1 1 1 7 1
1 1 1 1 1 1 1 1 1 1 3 4 4 4 4 4 1 1 7 1 7 1 1 1 1 1 1 1 1 1 3 4 4 4 4 4 1 1 7 1
1 1 1 1 1 1 1 7 1 1 1 1 1 1 1 4 1 1 7 1 7 1 1 1 1 1 1 7 1 1 1 1 1 1 1 4 1 1 7 1
1 1 1 1 1 1 1 1 1 1 1 1 1 1 1 4 1 1 7 1 7 1 1 1 1 1 1 1 1 1 1 1 1 1 1 4 1 1 7 1
1 7 1 1 1 1 1 1 1 1 5 1 1 1 1 1 1 1 7 1 7 7 1 1 1 1 1 1 1 1 5 1 1 1 1 1 1 1 7 1
1 7 1 1 7 1 1 1 1 1 5 1 1 1 1 1 1 1 7 1 7 7 1 1 7 1 1 1 1 1 5 1 1 1 1 1 1 1 7 1
1 1 7 1 7 1 1 7 1 1 5 1 1 1 1 1 1 1 7 1 7 1 7 1 7 1 1 7 1 1 5 1 1 1 1 1 1 1 7 1
1 1 1 1 7 1 1 7 1 1 5 1 1 1 1 1 1 1 7 1 7 1 1 1 7 1 1 7 1 1 5 1 1 1 1 1 1 1 7 1
1 7 7 7 7 1 7 7 1 1 5 5 5 5 5 1 1 1 1 1 7 7 7 7 7 1 7 7 1 1 5 5 5 5 5 1 1 1 1 1
1 1 1 1 1 1 1 1 1 1 1 1 1 1 1 1 1 1 1 1 7 1 1 1 1 1 1 1 1 1 1 1 1 1 1 1 1 1 1 1
1 1 1 1 1 1 1 1 1 1 1 1 1 1 1 1 1 1 1 1 7 1 1 1 1 1 1 1 1 1 1 1 1 1 1 1 1 1 1 1